A Fish Called Wanda - (John Cleese, Kevin Kline, Jamie Lee Curtis)
A Night At The Opera - (Marx Brothers)
Ace Ventura: Pet Detective - (Jim Carrey, Sean Young)
Adam's Rib - (Spencer Tracy, Katharine Hepburn)
Airplane! - (Robert Hayes, Julie Hagerty)
Annie Hall - (Woody Allen, Diane Keaton, Tony Roberts)
Arsenic and Old Lace - (Cary Grant, Josephine Hull, Peter Lorre)
Arthur - (Dudley Moore, Liza Minnelli)
Austin Powers: International Man of Mystery - (Mike Myers, Elizabeth Hurley)
Babes in Toyland - (Stan Laurel, Oliver Hardy)
Bananas - (Woody Allen, Carlos Montalban)
Beverly Hills Cop - (Eddie Murphy, Judge Reinhold)
Bill And Ted's Excellent Adventure - (Keanu Reeves, Alex Winter)
Blazing Saddles - (Mel Brooks, Gene Wilder)
Borat - (Sacha Baron Cohen, Ken Davitian)
Born Yesterday - (Judy Holliday, Broderick Crawford, William Holden)
Bringing Up Baby - (Cary Grant, Katharine Hepburn)
Broadcast News - (William Hurt, Albert Brooks, Holly Hunter)
Cat Ballou - (Jane Fonda, Lee Marvin, Dwayne Hickman)
Dr. Strangelove - (Peter Sellers, George C. Scott)
Duck Soup - (Marx Brothers)
Dumb and Dumber - (Jim Carrey, Jeff Daniels)
Everything You Always Wanted to Know About Sex... - (Woody Allen)
Ferris Bueller's Day Off - (Matthew Broderick, Alan Ruck, Mia Sara)
Ghostbusters - (Bill Murray, Dan Aykroyd, Sigourney Weaver)
Good Neighbor Sam - (Jack Lemmon, Romy Schneider, Dorothy Provine)
Groundhog Day - (Bill Murray, Andie MacDowell, Chris Elliott)
His Girl Friday - (Cary Grant, Rosalind Russell)
History of the World: Part 1 - (Mel Brooks, Madeline Kahn, Gregory Hines)
Home Alone - (Macaulay Culkin, Joe Pesci, Daniel Stern)
Hot Shots - (Charlie Sheen, Cary Elwes, Lloyd Bridges)
It's a Mad, Mad, Mad, Mad World - (Milton Berle, Jonathan Winters)
Juno - (Ellen Page, Jennifer Garner, Jason Bateman)
Little Miss Sunshine - (Greg Kinnear, Alan Arkin, Steve Carell)
Lost In America - (Albert Brooks, Julie Hagerty, Sylvia Farrel)
M*A*S*H - (Elliott Gould, Donald Sutherland, Sally Kellerman)
Meet the Parents - (Robert De Niro, Ben Stiller)
Monty Python and the Holy Grail - (Terry Gilliam, John Cleese, Eric Idle, etc.)
Monty Python's Life Of Brian - (John Cleese, Eric Idle)
Monty Python's Meaning Of Life - (John Cleese, Eric Idle)
My Cousin Vinny - (Joe Pesci, Marisa Tomei, Fred Gwynne)
National Lampoon's Animal House - (John Belushi, Tim Matheson)
No Time For Sergeants - (Andy Griffith, Mervyn LeRoy)
Office Space - (Ron Livingston, Jennifer Aniston)
Planes, Trains & Automobiles - (Steve Martin, John Candy)
Ruthless People - (Bette Midler, Danny DeVito)
Silver Streak - (Gene Wilder, Richard Pryor, Jill Clayburgh)
Sleeper - (Woody Allen, Diane Keaton)
Some Like It Hot - (Jack Lemmon, Tony Curtis, Marilyn Monroe)
Spaceballs - (Rick Moranis, Bill Pullman, John Candy)
Stir Crazy - (Richard Pryor, Gene Wilder)
Sullivan's Travels - (Joel McCrea, Veronica Lake)
Superbad - (Jonah Hill, Seth Rogen)
Tais-toi! - (GÃ©rard Depardieu, Jean Reno)
Take The Money And Run - (Woody Allen, Janet Margolin)
The 40 Year Old Virgin - (Steve Carell, Catherine Keener)
The Big Lebowski - (Jeff Bridges, John Goodman)
The Birdcage - (Robin Williams, Nathan Lane)
The Court Jester - (Danny Kaye, Basil Rathbone, Angela Lansbury)
The Gold Rush - (Charles Chaplin, Mack Swain, Tom Murray)
The Great Dictator - (Charles Chaplin, Paulette Goddard, Jack Oakie)
The Money Pit - (Tom Hanks, Shelley Long)
The Naked Gun - (Leslie Nielsen, Priscilla Presley)
The Producers - (Zero Mostel, Gene Wilder, Dick Shawn)
There's Something About Mary - (Cameron Diaz, Ben Stiller, Matt Dillon)
This Is Spinal Tap - (Michael McKean, Christopher Guest, Harry Shearer)
To Be or Not to Be - (Carole Lombard, Jack Benny, Robert Stack)
Tommy Boy - (Chris Farley, David Spade)
Tootsie - (Dustin Hoffman, Jessica Lange, Bill Murray)
Top Secret - (Val Kilmer, Lucy Gutteridge, Omar Sharif)
Trading Places - (Eddie Murphy, Dan Aykroyd)
Way Out West - (Stan Laurel, Oliver Hardy)
Wayne's World - (Mike Myers, Dana Carvey, Rob Lowe)
Young Frankenstein - (Gene Wilder, Marty Feldman, Peter Boyle) 


